#########
#@......#
#.......#
#.......#
#.......#
#.......#
#########