--------
|@......|
|.......|
|.......|
|.......|
|.......|
#########